
                                                        ______                                          111
          1111111111111              1111            __|1111|=|          1111111                111111111
        11      _____  11      1111111  11       1111111111112|        11       11             11    ______________
       11      |111|=|  11    11         11     11     |______|      11           1111111   111     |111111111111|=|
      11     __|11112|    11111         11     11                   11                  11111       |11111111111112|
      111111111111111|      11           1111111                  11  11         ________    11     |_____1111_____|
      11       |11111|       11                11      111     1111     111      |1111|=|     11          |11|
      11       |_____|     11  11                11       11  11  11             |111112|       11         11
       11                 11      ________        11        111    11      ______|111111|______   11       11
        1111        111111       |=211111|        11       11       1111  _|111111111111111111|     11   11         11
           11111   11     _______|____111|        1111111111           11111111111111111111111|      11111        11
  11       11   111      |111111111111111|                 111             |_____1111111______|     11    11111  11
    11    11     11      |_____1111__|___|  11              11111                |11111|_        1111         111
      11 11       11           |11|           11   1111111111    11              |111111111111111   __________   11
        11         11           11             11  11     11        11           |______|     11   |1111111112|    11
       11       __|11|__         11            1111       11         11                        11  |11111111|=|     11
        11     |111111|=|       1111          11     ____|11|____      11                    111   |___1111_|_|      11
         11    |11111112|     11   11   11  111      |1111111112|        11                111  11     |11|
          11   |________|   11       111  11         |11111111|=|          11111111111111111      11    11
            11111111111111111                        |________|_|         11                        11111
                                                                           11
                                                                            11
                                                                           11
                                                                          11 
                                                                         11
                                                                         11
                                                                        11